################################
#                       #e     #
#      #                #      #
#      #                #      #
#      #                #      #
#      #                #      #
#      #                #      #
#      #                #      #
#####  ###########      #      #
#                #      #      #
#                #      #      #
#             #  #      #      #
#             #  #      #      #
#             #  #      #      #
###########  ##                #
#            ###################
#             #                #
#             #                #
#             #   p            #
#           e #                #
#  ############                #
#       #                      #
#    #        #             e  #
################################